0 0 0 0 0 0 0 0 0 0 0 0 0 0 0 0 0 0 0 0 
0 0 0 2 2 2 2 1 1 1 1 1 1 2 2 2 0 0 0 0 
0 0 0 2 2 1 1 1 2 2 2 2 1 1 1 2 2 2 0 0 
2 2 2 2 1 1 2 2 2 2 2 2 2 2 1 2 2 2 0 0 
3 2 2 1 1 2 2 2 2 0 2 2 2 2 1 2 2 2 0 0 
3 1 1 1 2 2 2 0 0 0 0 2 2 2 1 1 1 2 2 2 
3 2 2 2 2 2 2 0 0 0 0 2 2 2 2 2 1 1 1 2 
0 0 0 0 0 0 0 0 0 0 0 0 0 0 0 0 2 2 1 2 
0 0 0 0 0 0 0 0 0 0 0 0 0 0 0 0 2 2 1 2 
0 0 0 0 0 0 0 0 0 0 0 0 0 0 0 2 2 2 1 2 
0 0 0 0 0 0 0 0 0 0 0 0 0 2 2 2 1 1 1 2 
0 0 0 0 0 0 0 0 0 0 0 0 2 2 2 1 1 2 2 2 
0 0 0 0 2 0 0 0 0 0 0 0 2 4 4 1 2 2 0 0 
0 0 0 0 0 0 0 0 0 0 0 2 2 4 4 2 2 0 0 0 
0 0 0 0 0 0 0 0 0 0 0 0 0 0 0 0 0 0 0 0 