0 0 0 0 0 0 0 0 0 0 0 0 0 0 0 0 0 0 0 0 
2 2 2 2 2 2 2 0 0 0 0 0 0 2 2 2 2 2 2 2 
2 2 2 2 2 0 0 0 0 0 0 0 0 0 0 0 2 2 2 2 
2 2 2 0 0 0 0 0 1 1 1 1 0 0 0 0 0 2 2 2 
2 2 0 0 0 0 1 1 1 0 0 1 1 1 0 0 0 0 2 2 
4 0 0 0 1 1 1 0 0 0 0 0 0 1 1 1 0 0 0 0 
4 1 1 1 1 0 0 0 0 0 0 0 0 0 0 1 1 0 0 0 
4 0 0 0 0 0 0 0 2 2 2 2 2 0 0 0 1 0 0 0 
4 1 1 1 0 0 0 0 2 2 2 2 2 0 0 0 1 1 1 0 
4 0 0 1 1 1 0 0 0 0 0 0 0 0 0 0 0 0 1 3 
2 0 0 0 0 1 1 0 0 0 0 0 0 0 0 0 0 0 1 3 
2 2 0 0 0 0 1 0 0 0 0 0 0 0 0 0 1 1 1 3 
2 2 2 2 0 0 1 1 1 1 1 1 1 1 1 1 1 0 0 0 
2 2 2 2 0 0 0 0 0 0 0 0 0 0 0 0 0 0 2 2 
2 2 2 2 2 2 0 0 0 0 0 0 0 0 0 0 0 2 2 2 
